    Abi o Abby: Variante de Abigail.
    Abigail: Fuente de alegría.
    Abril: Apertura.
    Ada: La que irradia belleza o la que irradia alegría.
    Adabella: Compuesto de Ada y Bella.
    Adalia: Seguidora del Dios del fuego.
    Adela: De noble linaje.
    Adelaida: De estirpe noble.
    Adelina: Amiga noble.
    Adoración: Admiración suprema.
    Adriana: Urraca o Nacida en la ciudad del mar.
    Afra: La que vino de Africa.
    Agata: La sublime, la virtuosa.
    Agustina:La que merece veneración.
    Aiala: Valle de Alava.
    Aida: Dirigente Aidé.
    Ailén: La brasa Ailin.
    Aimé: lo que significa algo.
    Alba: De piel blanca.
    Albina: Variante de Alba.
    Alda: Bellísima.
    Aldana: Compuesto de Alda y Ana.
    Alejandra: Vencedora.
    Alejandrina: Derivado de Alejandra.
    Alexia: La que defiende, la que ayuda.
    Alfonsa: Noble y lista para combatir.
    Alfonsina: Variante de Alfonsa.
    Alicia: Noble.
    Alida: Variante de Elida.
    Alina: Amiga noble.
    Alma: Espíritu vivificador.
    Almudena: Muralla (en árabe).
    Amada: Querida.
    Amalia: Abeja del hogar.
    Amanda: Digna de ser amada.
    Amapola: Alude a la flor del mismo nombre.
    Amaru: serpiente, boa Amaya.
    Ambar: Piedra preciosa.
    Amelia: Abeja del hogar.
    Amira:La que es princesa.
    Amparo: Protectora.
    Ana:Gracia de Dios.
    Anabella: Compuesto de Ana y Bella.
    Anahí: ceibo.
    Analía: Compuesto de Ana y Lía.
    Andrea: Viril.
    Andreína: Variante de Andrea.
    Angela: Buena, pura.
    Angeles: mensajera celeste.
    Angélica: Como un ángel.
    Angelina: Niña, pura, mensajera de Dios.
    Antonia: Florida.
    Antonieta: Florida, llena de gracia.
    Araceli: Altar del cielo.
    Aranzazu: Sierra de abundantes picos.
    Ariana: Variante de Adriana.
    Ariela: de Ariel, León de Dios.
    Artemisa: Diosa de la caza.
    Ascensión: Subida.
    Astrid: Fuerza de Dios.
    Asunción: Elevación.
    Atahualpa: El ave de la fortuna.
    Atzimba: Bella princesita.
    Aura: Dorada.
    Aurelia: Dorada, luminosa.
    Aurora: Dorada, amanecer.
    Ayelén: sonrisa, alegría.
    Azahar: Origen Arabe y significa Flor del Naranjo.
    Azucena: Lirio.
    Azul: Del color del cielo.
