    Aarón: Alta montaña.
    Abdallah: El siervo de Dios.
    Abdul: De origen árabe. Siervo del Señor.
    Abel: El hijo o vanidoso.
    Abelardo: El que trabaja como una abeja.
    Abi: Hebreo.Dios es mi padre, hijo del Señor.
    Abner: De origen hebreo. Padre de la luz.
    Abraham: Hebreo. Padre de una multitud.
    Absalón: Padre y señor de la paz.
    Adalberto: Perteneciente a la nobleza.
    Adam: Variante de Adán
    Adán: Hombre hecho de barro.
    Adelardo: Griego. El príncipe que es audaz.
    Adelio: Germánico. Padre del príncipe noble.
    Adelmaro: Griego. Ilustre por su estirpe.
    Adelmo: Germánico. Noble protector.
    Ademar: Ilustre por sus luchas. Célebre.
    Adiel: Fue adornado por Dios.
    Adolfo: De noble estirpe.
    Adonai: Señor mío.
    Adonías: Dios es mi Señor.
    Adonis: El más hermoso de los hombres.
    Adrián: Nacido en Adria, ciudad de Italia.
    Adriano: Variante de Adrián
    Adriel: Hebreo. Pertenece a la grey de Dios.
    Agamenón: Lento, que tarda en avanzar.
    Agapito: De origen hebreo. El muy amado.
    Agustín: Merece veneración. Familia imperial.
    Aladino: Arabe. Alcanzó la cumbre del saber.
    Alain: Forma francesa de Alan.
    Alan: El hombre imponente, apuesto.
    Albano: Germánico. De la casa de los Alba.
    Alberto: Que brilla por su nobleza.
    Albino: De tez muy blanca.
    Alcides: Griego. Fuerte y vigoroso.
    Aldo: Noble, lleno de experiencia. Caudillo.
    Alejandro: Protector de los hombres.
    Alejo: Que protege y defiende.
    Alex: Variante de Alexis.
    Alexis: Variante de Alejo. Defensor.
    Alfonso: Guerrero preparado para combate.
    Alfredo: El consejero ingenioso. Pacífico.
    Alí: Sublime, superior, elevado.
    Alonso: Variante de Alfonso.
    Alterio: Como un cielo estrellado.
    Alvaro: Totalmente prudente. Atento.
    Amadeo: El que ama a Dios.
    Amado: El que es objeto de amor.
    Amador: Prodiga amor.
    Amalio: Hombre que es despreocupado.
    Aman: El magnífico.
    Amando: Amado por todos.
    Amaru: Quechua. Serpiente sagrada.
    Ambrosio: El eterno, el inmortal.
    Amelio: Muy trabajador, enérgico.
    Américo: El príncipe en acción.
    Amílcar: El que manda en la ciudad.
    Amín:Hombre que es fiel.
    Amir: El jefe.
    Amón o Ami: Hebreo. El constructor.
    Amós: De origen hebreo. Hombre robusto.
    Ampelio:Griego. Hace vino con sus uvas.
    Anacleto: Griego. El que fue invocado.
    Anastasio: Griego. El que resucitó.
    Anatolio: Griego. Que vino de Oriente.
    Andrea: Forma italiana de Andrés.
    Andrés: Griego. Viril, varón, hombre ilustre.
    Angel o Angelo: Griego. Mensajero de Dios.
    Aniano: Griego. Está triste y afligido.
    Anías: De origen hebreo. Dios contesta.
    Aníbal: Púnico. Posee la gracia de Dios.
    Aniceto: Griego. Invencible, de gran fuerza.
    Anselmo: Germánico. El protegido de Dios.
    Antenor: De origen griego. El que combate.
    Antón: Forma reducida de Antonio (ver).
    Antonio: Floreciente, bello como una flor.
    Aparicio: Por las apariciones de la virgen.
    Apolinario: Variante de Apólito.
    Apólito: Latino. Dedicado al Dios Apolo.
    Apolo: Griego. Da vida y ahuyenta el mal.
    Aquiles: Griego. El que consuela en el dolor.
    Arcángel: Griego. El príncipe de los ángeles.
    Ari: Diminutivo de Ariel o Aristóteles.
    Ariel: De origen hebreo. El león de Dios.
    Aristóteles: Griego.Tiene nobles propósitos.
    Armando: De origen germánico. El guerrero.
    Armentario:Griego. Pastor de ganado.
    Arnaldo: Germánico. Que protege y vigila.
    Arnoldo: Variante de Arnaldo.
    Arquímedes: Griego. Pensador profundo.
    Arsenio:Griego. Varonil y vigoroso.
    Artemio: De origen griego. Integro, intacto.
    Arturo: Celta. El guardián de la Osa.
    Asaf: De origen hebreo. Escogido por Dios.
    Atahualpa: Quechua. Ave de la fortuna.
    Atilio: Latino. El favorito del abuelo.
    Augusto: Latino. El que merece fama.
    Aureliano: Variante de Aurelio.
    Aurelio: Latino. Que tiene el valor del oro.
    Avelino: El que nació en Avella, Italia.
    Axel: Variante de Absalón.
    Azarías: Hebreo. El Señor me guía.
    Azariel: Hebreo. El que domina las aguas.
